111111111111111111
100000000000000001
100000000000000P01
100000000000000001
10E00000C000000001
111111111111111111
10FFF000000F000F01
100F0000F00F000F01
1000FF00F000000001
111111111111111111
111111101F11111111
111111111111111111
