111111111111
100P00111111
1C0000111111
1000001111F1
10E000111111
100000111111
111111111111
