11111111111111111111111111111
1EC00000000000000000000000001
100000000000000000000000000P1
10000011111111111111111000001
10000010000000000000001000001
10000010000000F00000001000001
10000010000000000000001000001
10000010000000000000001000001
10000010000000000000001000001
10000010000000000000001000001
10000010000000000000001000001
10000011111111111111111000001
10000000000000000000000000001
10000000000000000000000000001
10000000000000000000000000001
10000000000000000000000000001
11111111111111111111111111111
