11111111111111111111
1CCCCCCCCCCCCCCCCCC1
1CCCCCCCCCCCCCCCCCC1
1CCCCCCCCCCCCCCCCCC1
1CCCCCCCCCCCCCCCCCC1
1CCCCCCCCCCCCCCCCCC1
1CCCCCCCECCCCCCCCCC1
1CCCCCCCCCCCCCCCCCC1
1CCCCCCCCCCCCCCCCCC1
1CCCCCCCCCCCCCCCCCC1
1CCCCCCCCCCCCPCCCCC1
1CCCCCCCCCCCCCCCCCC1
1CCCCCCCCCCCCCCCCCC1
11111111111111111111
