111111111111111111111111111111111111111111111111111111111111
1000000000C0000000000000000E000000000000C0000000000000000001
100000000000000000000000000000000000000000000000000000000001
100000000000000000000000000000000000000000000000000000000001
100000000000000000000000000000000000000000000000000000000001
10000C000000000000000000000000000000000000000000000000000001
100000000000000000000000000000000000000000C00000000000000001
10000000000000000000000C000000000000000000000000000000000001
100000000C00000000000000000000000000000000000000000000000001
100000000000000000000000000000000000000000000000000000000001
1000000000000C0000000000000000000000000000000000000000000001
100000000000000000000000000000000000000000000F000000F00000F1
100000000000000000000000000000000000000000000000000000000001
1000000000000C0000000000000000000000000000000000000000000001
1000000C00000000000000000000C000000000000000F000000000000001
100000000000000000000000000000000000000000000000000000000001
1000000000C00000000000000000000000000000000000000000000000P1
100000000000000000000000000000000000000000C00000000F00000001
111111111111111111111111111111111111111111111111111111111111
