111111111111111
1C010F00000C111
100001111100111
1P0011E0000F1F1
111111111111111
