111111111111111
1C010000000C111
100001111100111
1P0011E00000101
111111111111111
