111111111111111111111111111111111111
1E0000000000000C00000P00000000000111
101001010010000010100100000001010111
101001001010101000100100000001010101
100000000C00C0000000000000000000C111
111111111111111111111111111111111111
